LocalizedNameWindowsComboButton=Drop Down Button
LocalizedNameWindowsHorizontalScrollBar=Horizontal Scroll Bar
LocalizedNameWindowsVerticalScrollBar=Vertical Scroll Bar
LocalizedNameWindowsMenuBar=Application
LocalizedNameWindowsMenu=Menu
LocalizedNameWindowsMenuSeparator=separator
LocalizedNameWindowsSystemMenuBar=System Menu Bar
LocalizedNameWindowsSystemMenuItem=System
LocalizedNameWindowsReBarBandItem=Rebar Band
LocalizedNameWindowsScrollBarBitsBackBySmallAmount=Back by small amount
LocalizedNameWindowsScrollBarBitsBackByLargeAmount=Back by large amount
LocalizedNameWindowsScrollBarBitsThumb=Thumb
LocalizedNameWindowsScrollBarBitsForwardByLargeAmount=Forward by large amount
LocalizedNameWindowsScrollBarBitsForwardBySmallAmount=Forward by small amount
LocalizedNameWindowsSliderItemBackByLargeAmount=Back by large amount
LocalizedNameWindowsSliderItemThumb=Thumb
LocalizedNameWindowsSliderItemForwardByLargeAmount=Forward by large amount
LocalizedNameWindowsSysHeader=Header
LocalizedNameWindowsTitleBarButtonRestore=Restore
LocalizedNameWindowsTitleBarButtonMinimize=Minimize
LocalizedNameWindowsTitleBarButtonContextHelp=Context help
LocalizedNameWindowsTitleBarButtonMaximize=Maximize
LocalizedNameWindowsTitleBarButtonClose=Close
LocalizedNameWindowsTitleBarButtonUnknown=Unknown title bar button
LocalizedNameWindowsUpDown=Spin
LocalizedNameWindowsSpinButtonItemBackward=Backward
LocalizedNameWindowsSpinButtonItemForward=Forward
LocalizedControlTypeIPAddress=ip address
LocalizedControlTypeOctet=Octet
LocalizedControlTypeRebar=Rebar
LocalizedControlTypeRebarBand=Rebar Band
LocalizedControlTypeGrip=Grip
LocalizedControlTypeDialog=Dialog
LocalizedControlTypeContainer=Container
KeyAlt=Alt
KeyCtrl=Ctrl
KeyControl=Control
KeyShift=Shift
KeyHome=Home
KeyEnd=End
KeyDel=Del
KeyDelete=Delete
KeyIns=Ins
KeyInsert=Insert
KeyPageUp=Page Up
KeyPageDown=Page Down
KeyEsc=Esc
KeyScrLk=ScrLk
KeyPause=Pause
KeySysRq=SysRq
KeyPrtScn=PrtScn
KeyTab=Tab
KeyHelp=Help
KeySpace=Space
KeyWinKey=WinKey
